R       1000 2000
NO      ./texture/blue_brick.xpm
SO      ./texture/brick.xpm
WE      ./texture/eagle.xpm
EA      ./texture/moss.xpm

S       ./texture/tree.xpm
F       20,148,20
C       84,151,254



11111111111111111
10000000000000001
10000200000000121
10000000000000001
10000002000000001
10000020000000021
10020000000002001
10000000000000001
10000000002000001
10000000N00000001
10000000000000001
10000222220000001
10000000000000001
10000000000002001
10000022200000001
10000000000000001
11111111111111111
